%%%%%%%%
%P  H%.%
%   H G%
%...H .%
%...H .%
%...H .%
%...H .%
%J..H .%
%%%%%%%%